....#########
....#r-- --7#
....#|..0..|#
#####|..1.. #
!---- ..+..|#
#@..?... ..L%
#############